#####         \n
#   ##        \n
#    #  ####  \n
# B  ####  #  \n
#  BB B   B#  \n
###P #B    ## \n
 #  ##  B B ##\n
 # B  ## ## x#\n
 #  #B##B  #x#\n
 ###   Bxx##x#\n
  #    #x0xxx#\n
  # BB #xxxxx#\n
  #  #########\n
  #  #        \n
  ####        \n
