##############
#      # xB  #
#  x   # xB  #
#   B  # xB  #
#      ####  #
#     P   #  #
#         #  #
#    B    #  #
#     x      #
##############